abstraction-n	concept-n	0
accusation-n	statement-n	0
ache-n	pain-n	0
acid-n	chemical-n	0
acoustics-n	discipline-n	0
adjective-n	word-n	0
adrenaline-n	chemical-n	0
adrenaline-n	neurotransmitter-n	0
aesthetic-n	doctrine-n	0
affection-n	feeling-n	0
affidavit-n	document-n	0
agony-n	feeling-n	0
aide-n	serviceman-n	0
aircraft-n	vehicle-n	0
aircrew-n	crew-n	0
airman-n	worker-n	0
airplane-n	vehicle-n	0
alcohol-n	fluid-n	0
alderman-n	representative-n	0
ale-n	alcohol-n	0
ale-n	fluid-n	0
alga-n	microorganism-n	0
algebra-n	mathematics-n	0
algebra-n	science-n	0
alley-n	thoroughfare-n	0
almond-n	tree-n	0
alpha-n	symbol-n	0
ambassador-n	diplomat-n	0
ambassador-n	worker-n	0
amphetamine-n	drug-n	0
amphibian-n	vehicle-n	0
anaesthetic-n	drug-n	0
anaesthetist-n	adult-n	0
anaesthetist-n	professional-n	0
analogy-n	inference-n	0
anatomy-n	discipline-n	0
aneurysm-n	disorder-n	0
anger-n	emotion-n	0
anger-n	feeling-n	0
animosity-n	emotion-n	0
animosity-n	feeling-n	0
annals-n	periodical-n	0
anorexia-n	disorder-n	0
answer-n	statement-n	0
ant-n	insect-n	0
ant-n	invertebrate-n	0
antibiotic-n	drug-n	0
antibody-n	molecule-n	0
antiquity-n	era-n	0
apathy-n	feeling-n	0
ape-n	animal-n	0
ape-n	mammal-n	0
aphid-n	insect-n	0
aphid-n	invertebrate-n	0
apostle-n	believer-n	0
apple-n	solid-n	0
apprehension-n	fear-n	0
aquarium-n	container-n	0
aqueduct-n	conduit-n	0
archbishop-n	clergyman-n	0
archbishop-n	priest-n	0
arithmetic-n	discipline-n	0
armchair-n	chair-n	0
army-n	organization-n	0
aromatherapy-n	therapy-n	0
artery-n	vessel-n	0
artillery-n	armament-n	0
artiste-n	entertainer-n	0
artiste-n	performer-n	0
asp-n	reptile-n	0
asp-n	snake-n	0
asp-n	vertebrate-n	0
aspirin-n	drug-n	0
association-n	organization-n	0
assortment-n	collection-n	0
asthma-n	illness-n	0
astronomy-n	science-n	0
asylum-n	shelter-n	0
attorney-n	professional-n	0
attraction-n	phenomenon-n	0
auto-n	vehicle-n	0
autobiography-n	record-n	0
automobile-n	vehicle-n	0
baby-n	offspring-n	0
bacterium-n	microorganism-n	0
badminton-n	sport-n	0
baggage-n	container-n	0
bailiff-n	worker-n	0
balloon-n	aircraft-n	0
bamboo-n	wood-n	0
ban-n	decree-n	0
bargain-n	agreement-n	0
baritone-n	entertainer-n	0
baritone-n	singer-n	0
baroness-n	aristocrat-n	0
baronetcy-n	status-n	0
barrier-n	obstruction-n	0
basket-n	container-n	0
basketball-n	game-n	0
bassist-n	entertainer-n	0
bassist-n	musician-n	0
bat-n	vertebrate-n	0
batsman-n	athlete-n	0
batsman-n	player-n	0
battleship-n	ship-n	0
battleship-n	vehicle-n	0
bead-n	jewelry-n	0
bean-n	vegetable-n	0
bear-n	carnivore-n	0
bear-n	mammal-n	0
bear-n	vertebrate-n	0
beard-n	hair-n	0
bed-n	furniture-n	0
bee-n	animal-n	0
bee-n	invertebrate-n	0
beech-n	tree-n	0
beer-n	beverage-n	0
beer-n	liquid-n	0
bend-n	curve-n	0
benzene-n	chemical-n	0
benzene-n	hydrocarbon-n	0
benzodiazepine-n	drug-n	0
bereavement-n	emotion-n	0
berry-n	solid-n	0
bestseller-n	publication-n	0
beverage-n	fluid-n	0
beverage-n	liquid-n	0
bib-n	fabric-n	0
bike-n	vehicle-n	0
binder-n	machine-n	0
bingo-n	game-n	0
biochemistry-n	chemistry-n	0
biochemistry-n	science-n	0
biologist-n	scientist-n	0
biotechnology-n	discipline-n	0
biplane-n	aircraft-n	0
biplane-n	airplane-n	0
biplane-n	vehicle-n	0
bird-n	animal-n	0
birthday-n	anniversary-n	0
bitterness-n	emotion-n	0
bitterness-n	feeling-n	0
black-n	color-n	0
blaze-n	combustion-n	0
bluegrass-n	herb-n	0
boar-n	mammal-n	0
bomber-n	aircraft-n	0
bomber-n	airplane-n	0
bonnet-n	clothing-n	0
bonnet-n	commodity-n	0
bookmark-n	marker-n	0
bookshop-n	shop-n	0
booze-n	beverage-n	0
booze-n	drug-n	0
border-n	boundary-n	0
boss-n	leader-n	0
bottle-n	container-n	0
boulevard-n	thoroughfare-n	0
bounty-n	payment-n	0
bourgeoisie-n	people-n	0
bowling-n	game-n	0
box-n	container-n	0
bra-n	clothing-n	0
breaker-n	worker-n	0
breeze-n	wind-n	0
brethren-n	organization-n	0
bridesmaid-n	woman-n	0
brigade-n	organization-n	0
bronze-n	alloy-n	0
brook-n	stream-n	0
brother-n	kinsman-n	0
buffalo-n	mammal-n	0
bug-n	animal-n	0
bug-n	invertebrate-n	0
buggy-n	container-n	0
buggy-n	vehicle-n	0
bull-n	animal-n	0
bull-n	mammal-n	0
bulldog-n	dog-n	0
bungalow-n	house-n	0
bungalow-n	housing-n	0
bureau-n	organization-n	0
butcher-n	merchant-n	0
butter-n	solid-n	0
butterfly-n	animal-n	0
butterfly-n	insect-n	0
cabbage-n	vegetable-n	0
cafe-n	restaurant-n	0
cage-n	enclosure-n	0
cairn-n	symbol-n	0
calamity-n	misfortune-n	0
calculation-n	procedure-n	0
calf-n	animal-n	0
camera-n	equipment-n	0
cameraman-n	artist-n	0
campsite-n	site-n	0
candy-n	food-n	0
cannon-n	armament-n	0
cannon-n	artillery-n	0
carbohydrate-n	molecule-n	0
carbonate-n	chemical-n	0
carcinoma-n	cancer-n	0
carcinoma-n	tumor-n	0
cardinal-n	bishop-n	0
cardinal-n	leader-n	0
caring-n	love-n	0
carnage-n	murder-n	0
carp-n	seafood-n	0
carpenter-n	worker-n	0
casket-n	container-n	0
cassette-n	container-n	0
castle-n	building-n	0
castle-n	dwelling-n	0
castle-n	house-n	0
castle-n	housing-n	0
cat-n	carnivore-n	0
cat-n	mammal-n	0
cataract-n	illness-n	0
catastrophe-n	misfortune-n	0
catcher-n	player-n	0
caterpillar-n	larva-n	0
caucus-n	gathering-n	0
celery-n	herb-n	0
cellist-n	entertainer-n	0
cellist-n	performer-n	0
cellulose-n	carbohydrate-n	0
cellulose-n	chemical-n	0
cemetery-n	site-n	0
cereal-n	herb-n	0
chalet-n	building-n	0
chalet-n	house-n	0
chamber-n	enclosure-n	0
champagne-n	alcohol-n	0
champagne-n	wine-n	0
chancellor-n	leader-n	0
chant-n	music-n	0
chapel-n	building-n	0
charcoal-n	carbon-n	0
chariot-n	vehicle-n	0
charity-n	institution-n	0
chateau-n	dwelling-n	0
checklist-n	information-n	0
checklist-n	list-n	0
cheese-n	food-n	0
chef-n	worker-n	0
chemistry-n	science-n	0
chemotherapy-n	care-n	0
chick-n	animal-n	0
chick-n	bird-n	0
chick-n	vertebrate-n	0
chicken-n	solid-n	0
chilli-n	vegetable-n	0
chimpanzee-n	mammal-n	0
chimpanzee-n	vertebrate-n	0
chocolate-n	food-n	0
church-n	organization-n	0
cider-n	fluid-n	0
cipher-n	message-n	0
classroom-n	room-n	0
clerk-n	worker-n	0
clinician-n	professional-n	0
clown-n	fool-n	0
club-n	organization-n	0
clubhouse-n	building-n	0
coach-n	trainer-n	0
coaching-n	occupation-n	0
cockroach-n	insect-n	0
cockroach-n	invertebrate-n	0
cocktail-n	alcohol-n	0
cold-n	illness-n	0
collagen-n	molecule-n	0
collagen-n	protein-n	0
colon-n	organ-n	0
colt-n	male-n	0
columnist-n	journalist-n	0
comedian-n	performer-n	0
comic-n	entertainer-n	0
comic-n	performer-n	0
comment-n	statement-n	0
commission-n	organization-n	0
committee-n	organization-n	0
company-n	institution-n	0
company-n	organization-n	0
compass-n	instrument-n	0
compassion-n	feeling-n	0
competitiveness-n	trait-n	0
complacency-n	feeling-n	0
compost-n	mixture-n	0
concert-n	performance-n	0
concerto-n	music-n	0
condom-n	contraceptive-n	0
condominium-n	dwelling-n	0
condominium-n	housing-n	0
conjecture-n	idea-n	0
conservatism-n	attitude-n	0
contract-n	statement-n	0
convent-n	building-n	0
convent-n	dwelling-n	0
convention-n	meeting-n	0
conversion-n	transformation-n	0
cook-n	worker-n	0
cookbook-n	book-n	0
cookie-n	solid-n	0
cool-n	temperature-n	0
copyright-n	right-n	0
coriander-n	herb-n	0
corporation-n	organization-n	0
corridor-n	passageway-n	0
cosmology-n	discipline-n	0
cottage-n	house-n	0
cottage-n	housing-n	0
cotton-n	fiber-n	0
council-n	organization-n	0
counterattack-n	attack-n	0
country-n	organization-n	0
coupe-n	vehicle-n	0
courthouse-n	building-n	0
courtroom-n	room-n	0
covenant-n	document-n	0
cow-n	vertebrate-n	0
cowboy-n	workman-n	0
crab-n	invertebrate-n	0
cracker-n	food-n	0
cradle-n	furniture-n	0
craftsman-n	professional-n	0
cricket-n	insect-n	0
cricketer-n	athlete-n	0
criminology-n	discipline-n	0
crocodile-n	animal-n	0
croquet-n	game-n	0
croquet-n	sport-n	0
crow-n	animal-n	0
crusade-n	undertaking-n	0
cutlery-n	tool-n	0
cycling-n	sport-n	0
cynicism-n	feeling-n	0
dad-n	progenitor-n	0
dad-n	relative-n	0
daddy-n	parent-n	0
dagger-n	instrument-n	0
dance-n	art-n	0
dancer-n	entertainer-n	0
dancing-n	discipline-n	0
dart-n	projectile-n	0
daughter-n	offspring-n	0
deafness-n	disability-n	0
dealer-n	merchant-n	0
dealership-n	business-n	0
dean-n	leader-n	0
deanery-n	building-n	0
deanery-n	dwelling-n	0
deanery-n	house-n	0
declaration-n	statement-n	0
decrease-n	change-n	0
deer-n	animal-n	0
deer-n	mammal-n	0
dementia-n	insanity-n	0
denim-n	clothing-n	0
dentistry-n	medicine-n	0
dentistry-n	science-n	0
department-n	organization-n	0
depth-n	magnitude-n	0
dermatitis-n	disease-n	0
descendent-n	relative-n	0
desire-n	feeling-n	0
desk-n	furniture-n	0
detective-n	policeman-n	0
diabetes-n	disease-n	0
dictionary-n	book-n	0
dinghy-n	boat-n	0
dinner-n	meal-n	0
dinosaur-n	vertebrate-n	0
dioxide-n	oxide-n	0
dioxin-n	hydrocarbon-n	0
diplomat-n	worker-n	0
directorate-n	organization-n	0
disappointment-n	feeling-n	0
disco-n	music-n	0
discussion-n	communication-n	0
dish-n	container-n	0
dispenser-n	container-n	0
displeasure-n	emotion-n	0
documentary-n	movie-n	0
documentation-n	information-n	0
dog-n	carnivore-n	0
dog-n	mammal-n	0
dogma-n	doctrine-n	0
dolphin-n	animal-n	0
dorm-n	housing-n	0
dormitory-n	building-n	0
dove-n	animal-n	0
draft-n	document-n	0
dragonfly-n	animal-n	0
dragonfly-n	insect-n	0
dramatist-n	writer-n	0
drift-n	phenomenon-n	0
drinker-n	consumer-n	0
drizzle-n	rain-n	0
drone-n	insect-n	0
drummer-n	entertainer-n	0
drummer-n	performer-n	0
dryer-n	commodity-n	0
duck-n	bird-n	0
dustbin-n	bin-n	0
dwelling-n	housing-n	0
dyke-n	lesbian-n	0
dynamite-n	explosive-n	0
eagle-n	animal-n	0
eagle-n	bird-n	0
eagle-n	vertebrate-n	0
earring-n	decoration-n	0
eatery-n	building-n	0
eating-n	consumption-n	0
ecologist-n	scientist-n	0
economics-n	discipline-n	0
economist-n	scientist-n	0
ecstasy-n	emotion-n	0
ecstasy-n	feeling-n	0
edge-n	boundary-n	0
editor-n	worker-n	0
editorial-n	prose-n	0
educator-n	professional-n	0
eel-n	solid-n	0
electrician-n	worker-n	0
electrolyte-n	solution-n	0
electronics-n	discipline-n	0
electronics-n	science-n	0
elephant-n	animal-n	0
eleven-n	integer-n	0
elite-n	people-n	0
elm-n	tree-n	0
emigrant-n	migrant-n	0
emigration-n	migration-n	0
employee-n	worker-n	0
empress-n	ruler-n	0
encyclopedia-n	book-n	0
endurance-n	strength-n	0
engineering-n	occupation-n	0
enumeration-n	information-n	0
enumeration-n	list-n	0
environmentalist-n	reformer-n	0
envy-n	feeling-n	0
enzyme-n	molecule-n	0
enzymology-n	biochemistry-n	0
enzymology-n	science-n	0
epic-n	poem-n	0
epistle-n	letter-n	0
etching-n	art-n	0
excitement-n	feeling-n	0
excuse-n	explanation-n	0
experiment-n	research-n	0
facade-n	surface-n	0
fairytale-n	narrative-n	0
fallacy-n	idea-n	0
falsehood-n	statement-n	0
farmhouse-n	building-n	0
farmhouse-n	house-n	0
father-n	progenitor-n	0
feeder-n	animal-n	0
felony-n	transgression-n	0
fence-n	barrier-n	0
fencing-n	obstruction-n	0
fender-n	barrier-n	0
ferret-n	carnivore-n	0
ferry-n	boat-n	0
ferry-n	vehicle-n	0
fielder-n	athlete-n	0
fillet-n	meat-n	0
filly-n	female-n	0
final-n	contest-n	0
fingertip-n	tip-n	0
firearm-n	weapon-n	0
firm-n	business-n	0
firm-n	organization-n	0
fish-n	animal-n	0
fisherman-n	worker-n	0
fishing-n	sport-n	0
flea-n	invertebrate-n	0
flea-n	parasite-n	0
floor-n	surface-n	0
flour-n	food-n	0
flu-n	disease-n	0
fluorescence-n	phenomenon-n	0
fly-n	invertebrate-n	0
fodder-n	worker-n	0
foetus-n	vertebrate-n	0
folly-n	trait-n	0
football-n	game-n	0
football-n	sport-n	0
footbridge-n	bridge-n	0
forearm-n	limb-n	0
foreman-n	superior-n	0
fork-n	ware-n	0
foundry-n	plant-n	0
fourteen-n	integer-n	0
fox-n	animal-n	0
fox-n	mammal-n	0
fox-n	vertebrate-n	0
fragrance-n	sensation-n	0
freeware-n	software-n	0
freeway-n	road-n	0
fresco-n	art-n	0
fresco-n	painting-n	0
frigate-n	vehicle-n	0
fright-n	emotion-n	0
frustration-n	feeling-n	0
fullback-n	athlete-n	0
funeral-n	ceremony-n	0
gale-n	phenomenon-n	0
gall-n	disease-n	0
galley-n	vehicle-n	0
gas-n	phenomenon-n	0
gasoline-n	fuel-n	0
gasoline-n	hydrocarbon-n	0
gastropod-n	invertebrate-n	0
gate-n	barrier-n	0
gateway-n	entrance-n	0
gauge-n	instrument-n	0
geek-n	performer-n	0
gemstone-n	crystal-n	0
generator-n	apparatus-n	0
gent-n	adult-n	0
gentry-n	people-n	0
geology-n	discipline-n	0
geometry-n	discipline-n	0
geometry-n	science-n	0
gin-n	beverage-n	0
ginger-n	herb-n	0
girlfriend-n	woman-n	0
gladiator-n	combatant-n	0
gland-n	organ-n	0
glaucoma-n	disease-n	0
glider-n	aircraft-n	0
glider-n	vehicle-n	0
goalkeeper-n	athlete-n	0
goalkeeper-n	player-n	0
goat-n	mammal-n	0
goldfish-n	vertebrate-n	0
golf-n	sport-n	0
golfer-n	player-n	0
goose-n	vertebrate-n	0
goose-n	waterfowl-n	0
gorge-n	valley-n	0
gorilla-n	mammal-n	0
governor-n	politician-n	0
gown-n	clothing-n	0
graft-n	tissue-n	0
grandchild-n	offspring-n	0
grandchild-n	relative-n	0
granddaughter-n	offspring-n	0
grandfather-n	grandparent-n	0
grandmother-n	grandparent-n	0
grandmother-n	relative-n	0
granny-n	relative-n	0
graveyard-n	site-n	0
green-n	color-n	0
greyhound-n	animal-n	0
greyhound-n	dog-n	0
greyhound-n	hound-n	0
grove-n	vegetation-n	0
guesthouse-n	housing-n	0
gunboat-n	boat-n	0
gunboat-n	vehicle-n	0
gunner-n	serviceman-n	0
gym-n	facility-n	0
gymnasium-n	school-n	0
hall-n	passageway-n	0
hallway-n	passageway-n	0
hamlet-n	community-n	0
hamster-n	rodent-n	0
handgun-n	gun-n	0
handgun-n	instrument-n	0
handgun-n	weapon-n	0
handset-n	equipment-n	0
hardness-n	consistency-n	0
hare-n	animal-n	0
hare-n	mammal-n	0
hawk-n	animal-n	0
hawk-n	bird-n	0
headline-n	text-n	0
heat-n	energy-n	0
hedgehog-n	rodent-n	0
hedgehog-n	vertebrate-n	0
height-n	dimension-n	0
height-n	magnitude-n	0
helicopter-n	vehicle-n	0
hen-n	bird-n	0
henchman-n	criminal-n	0
hepatitis-n	illness-n	0
heroism-n	trait-n	0
herpes-n	disease-n	0
herring-n	seafood-n	0
heterogeneity-n	difference-n	0
highway-n	road-n	0
histogram-n	chart-n	0
hockey-n	sport-n	0
holly-n	tree-n	0
honey-n	food-n	0
horse-n	animal-n	0
horse-n	mammal-n	0
horse-n	vertebrate-n	0
horseman-n	rider-n	0
hose-n	commodity-n	0
hospital-n	building-n	0
hostel-n	hotel-n	0
hostess-n	host-n	0
house-n	building-n	0
housekeeper-n	servant-n	0
housewife-n	woman-n	0
human-n	vertebrate-n	0
humanism-n	doctrine-n	0
humanist-n	scholar-n	0
humankind-n	vertebrate-n	0
hurricane-n	storm-n	0
husband-n	relative-n	0
hymn-n	song-n	0
hypnotherapy-n	therapy-n	0
hypnotherapy-n	treatment-n	0
hysteria-n	disorder-n	0
ice-n	crystal-n	0
icon-n	signal-n	0
illustration-n	artwork-n	0
immigration-n	migration-n	0
immunology-n	discipline-n	0
immunology-n	science-n	0
importation-n	commerce-n	0
indemnity-n	security-n	0
infant-n	relative-n	0
influenza-n	illness-n	0
infusion-n	solution-n	0
initiation-n	ceremony-n	0
ink-n	fluid-n	0
ink-n	liquid-n	0
inn-n	building-n	0
insect-n	animal-n	0
insecticide-n	pesticide-n	0
insomnia-n	disorder-n	0
internment-n	captivity-n	0
interoperability-n	ability-n	0
intestine-n	organ-n	0
intranet-n	system-n	0
invertebrate-n	animal-n	0
investing-n	transaction-n	0
investment-n	transaction-n	0
invitation-n	text-n	0
ipod-n	system-n	0
islander-n	inhabitant-n	0
iv-n	digit-n	0
ix-n	digit-n	0
jacket-n	garment-n	0
jam-n	food-n	0
jealousy-n	feeling-n	0
jean-n	garment-n	0
jelly-n	food-n	0
jet-n	vehicle-n	0
jeweller-n	maker-n	0
jewelry-n	decoration-n	0
jigsaw-n	machine-n	0
jigsaw-n	tool-n	0
joker-n	entertainer-n	0
joker-n	performer-n	0
jurisprudence-n	discipline-n	0
kangaroo-n	animal-n	0
kangaroo-n	mammal-n	0
karaoke-n	entertainment-n	0
kestrel-n	animal-n	0
kestrel-n	falcon-n	0
kestrel-n	hawk-n	0
kestrel-n	vertebrate-n	0
kettle-n	container-n	0
kettle-n	utensil-n	0
keyboardist-n	performer-n	0
kickoff-n	kick-n	0
kidnapping-n	crime-n	0
kilt-n	clothing-n	0
kilt-n	commodity-n	0
kindergarten-n	institution-n	0
kindergarten-n	organization-n	0
kingfisher-n	bird-n	0
kingfisher-n	vertebrate-n	0
kinsman-n	relative-n	0
knee-n	joint-n	0
knife-n	tool-n	0
knuckle-n	joint-n	0
laboratory-n	workplace-n	0
laborer-n	worker-n	0
lactose-n	chemical-n	0
lactose-n	molecule-n	0
lady-n	adult-n	0
lamb-n	animal-n	0
laptop-n	computer-n	0
laptop-n	machine-n	0
leak-n	opening-n	0
lecturer-n	adult-n	0
leg-n	limb-n	0
lemon-n	fruit-n	0
leprosy-n	disease-n	0
leprosy-n	illness-n	0
leukaemia-n	cancer-n	0
leukaemia-n	disease-n	0
leukaemia-n	tumor-n	0
leukemia-n	tumor-n	0
librarian-n	adult-n	0
license-n	document-n	0
limousine-n	car-n	0
limousine-n	vehicle-n	0
lingerie-n	clothing-n	0
lingerie-n	garment-n	0
lingerie-n	underwear-n	0
linguist-n	scientist-n	0
linguistics-n	science-n	0
lion-n	animal-n	0
lion-n	vertebrate-n	0
lipid-n	molecule-n	0
liqueur-n	alcohol-n	0
liqueur-n	beverage-n	0
liqueur-n	fluid-n	0
liquor-n	beverage-n	0
liquor-n	fluid-n	0
liquor-n	liquid-n	0
lizard-n	reptile-n	0
lobster-n	seafood-n	0
locomotive-n	vehicle-n	0
logic-n	discipline-n	0
logo-n	signal-n	0
logo-n	symbol-n	0
longing-n	feeling-n	0
loo-n	room-n	0
louse-n	insect-n	0
love-n	feeling-n	0
lunch-n	meal-n	0
luncheon-n	meal-n	0
lupus-n	disease-n	0
lymphoma-n	tumor-n	0
mackerel-n	seafood-n	0
magazine-n	medium-n	0
maggot-n	animal-n	0
maggot-n	larva-n	0
magistrate-n	official-n	0
magpie-n	animal-n	0
magpie-n	bird-n	0
maid-n	servant-n	0
mail-n	message-n	0
mailbox-n	container-n	0
maize-n	herb-n	0
malaria-n	infection-n	0
man-n	adult-n	0
mango-n	tree-n	0
mangrove-n	tree-n	0
mankind-n	mammal-n	0
manor-n	housing-n	0
manual-n	book-n	0
manual-n	publication-n	0
maple-n	wood-n	0
mare-n	animal-n	0
mare-n	horse-n	0
mare-n	vertebrate-n	0
margarine-n	food-n	0
mariner-n	worker-n	0
marquee-n	tent-n	0
massage-n	treatment-n	0
mater-n	ancestor-n	0
math-n	science-n	0
measles-n	illness-n	0
medication-n	drug-n	0
medicine-n	discipline-n	0
melanoma-n	cancer-n	0
melanoma-n	carcinoma-n	0
melanoma-n	tumor-n	0
melon-n	fruit-n	0
melon-n	solid-n	0
memo-n	note-n	0
memo-n	record-n	0
memorandum-n	note-n	0
meningitis-n	illness-n	0
mesothelioma-n	cancer-n	0
mesothelioma-n	disease-n	0
mesothelioma-n	illness-n	0
mesothelioma-n	tumor-n	0
metro-n	railway-n	0
microbiology-n	biology-n	0
midwife-n	professional-n	0
migraine-n	ache-n	0
migrant-n	traveler-n	0
military-n	organization-n	0
militia-n	organization-n	0
milk-n	beverage-n	0
milk-n	fluid-n	0
milk-n	food-n	0
milk-n	liquid-n	0
mime-n	performer-n	0
miner-n	workman-n	0
mishap-n	phenomenon-n	0
missile-n	instrument-n	0
missile-n	weapon-n	0
mistress-n	woman-n	0
mob-n	crowd-n	0
modifier-n	word-n	0
mollusc-n	animal-n	0
mom-n	parent-n	0
monarch-n	ruler-n	0
monastery-n	building-n	0
monastery-n	dwelling-n	0
monastery-n	house-n	0
monastery-n	housing-n	0
monoclonal-n	molecule-n	0
monoclonal-n	protein-n	0
monsoon-n	wind-n	0
moratorium-n	pause-n	0
mortar-n	weaponry-n	0
mosque-n	building-n	0
motel-n	building-n	0
moth-n	insect-n	0
mother-n	ancestor-n	0
mother-n	progenitor-n	0
mother-n	relative-n	0
motorbike-n	vehicle-n	0
motorcycle-n	vehicle-n	0
motorist-n	driver-n	0
motorway-n	highway-n	0
motorway-n	road-n	0
motto-n	saying-n	0
mucosa-n	tissue-n	0
mule-n	animal-n	0
mule-n	mammal-n	0
multiculturalism-n	doctrine-n	0
mummy-n	ancestor-n	0
murderer-n	criminal-n	0
muse-n	deity-n	0
musket-n	gun-n	0
nanny-n	adult-n	0
nanotechnology-n	discipline-n	0
navy-n	organization-n	0
negation-n	statement-n	0
nematode-n	invertebrate-n	0
nerve-n	tissue-n	0
netball-n	game-n	0
neurology-n	science-n	0
neuroscience-n	discipline-n	0
neuroscience-n	science-n	0
nickname-n	name-n	0
nipple-n	organ-n	0
nostalgia-n	feeling-n	0
notary-n	official-n	0
noun-n	word-n	0
nurse-n	adult-n	0
nursing-n	work-n	0
oat-n	cereal-n	0
objectivity-n	trait-n	0
observatory-n	building-n	0
odour-n	sensation-n	0
odyssey-n	travel-n	0
officer-n	serviceman-n	0
oil-n	lipid-n	0
ointment-n	drug-n	0
olive-n	fruit-n	0
oncology-n	discipline-n	0
oncology-n	science-n	0
opium-n	narcotic-n	0
optimism-n	feeling-n	0
orange-n	solid-n	0
orator-n	speaker-n	0
orchid-n	flower-n	0
ore-n	mineral-n	0
organist-n	performer-n	0
osteoarthritis-n	arthritis-n	0
osteoarthritis-n	illness-n	0
outpost-n	post-n	0
overhead-n	cost-n	0
overpayment-n	payment-n	0
owl-n	bird-n	0
owl-n	vertebrate-n	0
ox-n	animal-n	0
oyster-n	animal-n	0
package-n	collection-n	0
paddle-n	stick-n	0
pair-n	set-n	0
palace-n	dwelling-n	0
pancreas-n	organ-n	0
panda-n	animal-n	0
panda-n	mammal-n	0
panda-n	vertebrate-n	0
panic-n	fear-n	0
parachute-n	equipment-n	0
parameter-n	concept-n	0
parapet-n	wall-n	0
parent-n	relative-n	0
parenthesis-n	symbol-n	0
parody-n	caricature-n	0
parrot-n	vertebrate-n	0
parser-n	software-n	0
passion-n	feeling-n	0
pathologist-n	doctor-n	0
pathology-n	science-n	0
patience-n	trait-n	0
pc-n	computer-n	0
pc-n	machine-n	0
pear-n	fruit-n	0
pear-n	produce-n	0
pearl-n	jewel-n	0
pearl-n	jewelry-n	0
penguin-n	animal-n	0
penguin-n	bird-n	0
penguin-n	seabird-n	0
penicillin-n	antibiotic-n	0
penis-n	organ-n	0
pennant-n	signal-n	0
pennant-n	symbol-n	0
penthouse-n	housing-n	0
peptide-n	chemical-n	0
percussionist-n	performer-n	0
perseverance-n	trait-n	0
pet-n	animal-n	0
petal-n	leaf-n	0
petroleum-n	chemical-n	0
petroleum-n	oil-n	0
pew-n	bench-n	0
pharmacology-n	science-n	0
pharmacy-n	discipline-n	0
pheasant-n	animal-n	0
pheasant-n	vertebrate-n	0
phonology-n	science-n	0
physician-n	adult-n	0
physician-n	professional-n	0
physiology-n	biology-n	0
physiology-n	science-n	0
physiotherapist-n	therapist-n	0
physiotherapy-n	therapy-n	0
physiotherapy-n	treatment-n	0
pianist-n	entertainer-n	0
pickup-n	vehicle-n	0
pig-n	swine-n	0
pigeon-n	vertebrate-n	0
pilgrimage-n	journey-n	0
pilot-n	worker-n	0
pine-n	tree-n	0
pipe-n	conduit-n	0
piper-n	entertainer-n	0
piper-n	musician-n	0
piper-n	performer-n	0
piracy-n	crime-n	0
pirate-n	criminal-n	0
pizza-n	food-n	0
platform-n	surface-n	0
platter-n	ware-n	0
playing-n	show-n	0
playlist-n	information-n	0
playlist-n	list-n	0
plum-n	tree-n	0
pocket-n	container-n	0
poet-n	writer-n	0
polarization-n	phenomenon-n	0
pollen-n	spore-n	0
polyethylene-n	resin-n	0
polymer-n	chemical-n	0
polymerase-n	chemical-n	0
polymerase-n	enzyme-n	0
pontoon-n	boat-n	0
pony-n	horse-n	0
pony-n	mammal-n	0
pope-n	leader-n	0
porter-n	employee-n	0
porter-n	worker-n	0
porter-n	workman-n	0
postcard-n	mail-n	0
postgraduate-n	student-n	0
postman-n	worker-n	0
potato-n	food-n	0
potato-n	vegetable-n	0
pouch-n	container-n	0
pram-n	vehicle-n	0
preamble-n	section-n	0
preconception-n	belief-n	0
prefecture-n	district-n	0
prelate-n	clergyman-n	0
premier-n	representative-n	0
preposition-n	word-n	0
president-n	leader-n	0
primacy-n	standing-n	0
primate-n	priest-n	0
princess-n	aristocrat-n	0
principle-n	idea-n	0
priory-n	house-n	0
privateer-n	mariner-n	0
privateer-n	sailor-n	0
probate-n	document-n	0
professorship-n	occupation-n	0
progenitor-n	ancestor-n	0
pronoun-n	word-n	0
propaganda-n	information-n	0
prosecutor-n	official-n	0
protein-n	molecule-n	0
pseudonym-n	name-n	0
psoriasis-n	disease-n	0
psoriasis-n	illness-n	0
psychiatry-n	science-n	0
psychoanalysis-n	therapy-n	0
psychoanalysis-n	treatment-n	0
psychoanalysis-n	work-n	0
psychology-n	science-n	0
psychotherapy-n	discipline-n	0
psychotherapy-n	science-n	0
publisher-n	firm-n	0
pudding-n	food-n	0
puppy-n	mammal-n	0
puppy-n	vertebrate-n	0
python-n	animal-n	0
python-n	reptile-n	0
python-n	vertebrate-n	0
quarterback-n	player-n	0
quartz-n	solid-n	0
questionnaire-n	document-n	0
rabbit-n	vertebrate-n	0
race-n	contest-n	0
racehorse-n	mammal-n	0
racing-n	sport-n	0
radar-n	instrument-n	0
radiation-n	phenomenon-n	0
radiotherapy-n	care-n	0
radiotherapy-n	treatment-n	0
radius-n	magnitude-n	0
rage-n	emotion-n	0
rain-n	phenomenon-n	0
rainforest-n	vegetation-n	0
rainwater-n	water-n	0
raisin-n	produce-n	0
range-n	magnitude-n	0
rat-n	mammal-n	0
raven-n	vertebrate-n	0
receiver-n	equipment-n	0
receptionist-n	worker-n	0
recovery-n	improvement-n	0
rectangle-n	polygon-n	0
rector-n	leader-n	0
red-n	color-n	0
reel-n	equipment-n	0
reelection-n	election-n	0
refreshment-n	food-n	0
regent-n	member-n	0
reggae-n	music-n	0
registry-n	record-n	0
reimbursement-n	compensation-n	0
reimbursement-n	payment-n	0
reindeer-n	animal-n	0
reliability-n	trait-n	0
relief-n	feeling-n	0
remorse-n	feeling-n	0
reptile-n	animal-n	0
reptile-n	vertebrate-n	0
resentment-n	emotion-n	0
reservist-n	serviceman-n	0
resident-n	inhabitant-n	0
resignation-n	feeling-n	0
retina-n	tissue-n	0
review-n	appraisal-n	0
revolver-n	pistol-n	0
rhino-n	vertebrate-n	0
rider-n	traveler-n	0
rifle-n	weapon-n	0
rig-n	equipment-n	0
roadway-n	road-n	0
roast-n	meat-n	0
robbery-n	crime-n	0
robin-n	animal-n	0
robin-n	vertebrate-n	0
rodent-n	animal-n	0
rodent-n	mammal-n	0
rodent-n	vertebrate-n	0
roofing-n	equipment-n	0
roster-n	list-n	0
royalty-n	payment-n	0
rucksack-n	bag-n	0
rue-n	herb-n	0
rugby-n	game-n	0
rum-n	drug-n	0
rum-n	fluid-n	0
rum-n	liquid-n	0
rune-n	signal-n	0
sack-n	bag-n	0
sadness-n	feeling-n	0
safari-n	travel-n	0
salesman-n	employee-n	0
salesman-n	worker-n	0
salmon-n	animal-n	0
salmon-n	fish-n	0
sandwich-n	food-n	0
sauna-n	room-n	0
sausage-n	solid-n	0
sawmill-n	machine-n	0
saxophonist-n	performer-n	0
scapegoat-n	victim-n	0
scarf-n	garment-n	0
schoolmaster-n	educator-n	0
scissors-n	tool-n	0
scourge-n	instrument-n	0
screen-n	surface-n	0
screenwriter-n	writer-n	0
screwdriver-n	tool-n	0
seabird-n	bird-n	0
seabird-n	vertebrate-n	0
seaman-n	sailor-n	0
seaplane-n	airplane-n	0
seaplane-n	vehicle-n	0
seawater-n	water-n	0
seaweed-n	alga-n	0
secret-n	information-n	0
secretariat-n	organization-n	0
sedan-n	car-n	0
sedan-n	vehicle-n	0
seminar-n	gathering-n	0
seminary-n	institution-n	0
serpent-n	animal-n	0
serpent-n	reptile-n	0
serpent-n	vertebrate-n	0
sewer-n	conduit-n	0
shareholder-n	investor-n	0
shark-n	fish-n	0
shaving-n	cleaning-n	0
shellfish-n	seafood-n	0
shellfish-n	solid-n	0
sherry-n	beverage-n	0
sherry-n	liquid-n	0
sherry-n	wine-n	0
shirt-n	clothing-n	0
shopkeeper-n	merchant-n	0
shortcut-n	road-n	0
shovel-n	tool-n	0
shower-n	fixture-n	0
shrine-n	building-n	0
silo-n	tower-n	0
sir-n	man-n	0
sis-n	relative-n	0
sixty-n	integer-n	0
size-n	magnitude-n	0
skating-n	sport-n	0
skier-n	athlete-n	0
skin-n	covering-n	0
skin-n	tissue-n	0
skull-n	tissue-n	0
slalom-n	contest-n	0
slogan-n	saying-n	0
sloop-n	vehicle-n	0
smallpox-n	illness-n	0
smuggler-n	criminal-n	0
snail-n	animal-n	0
snake-n	animal-n	0
snippet-n	piece-n	0
snooker-n	game-n	0
soccer-n	game-n	0
sociologist-n	scientist-n	0
sociology-n	science-n	0
soldier-n	serviceman-n	0
soloist-n	musician-n	0
soloist-n	performer-n	0
son-n	offspring-n	0
son-n	relative-n	0
song-n	music-n	0
soprano-n	entertainer-n	0
soprano-n	performer-n	0
soprano-n	singer-n	0
spacecraft-n	equipment-n	0
spaceship-n	vehicle-n	0
spaghetti-n	food-n	0
spaghetti-n	pasta-n	0
spasm-n	symptom-n	0
spear-n	instrument-n	0
spear-n	weapon-n	0
spectrometer-n	instrument-n	0
spinach-n	herb-n	0
spiral-n	curve-n	0
spokesman-n	spokesperson-n	0
spokeswoman-n	advocate-n	0
spokeswoman-n	spokesperson-n	0
spoon-n	container-n	0
spouse-n	relative-n	0
sprinter-n	athlete-n	0
squid-n	solid-n	0
stag-n	animal-n	0
stag-n	mammal-n	0
stagecoach-n	vehicle-n	0
stallion-n	animal-n	0
stallion-n	horse-n	0
staple-n	commodity-n	0
statesman-n	leader-n	0
stepfather-n	ancestor-n	0
stepmother-n	ancestor-n	0
stereo-n	equipment-n	0
stipend-n	payment-n	0
stocking-n	commodity-n	0
storyteller-n	communicator-n	0
strawberry-n	berry-n	0
strut-n	walk-n	0
studio-n	workplace-n	0
subcommittee-n	organization-n	0
subcontractor-n	contractor-n	0
submarine-n	ship-n	0
subtraction-n	calculation-n	0
suburb-n	district-n	0
suit-n	commodity-n	0
suitcase-n	container-n	0
sulphate-n	chemical-n	0
sundial-n	instrument-n	0
sunlight-n	light-n	0
sunshine-n	phenomenon-n	0
supercomputer-n	computer-n	0
supercomputer-n	machine-n	0
supper-n	meal-n	0
surcharge-n	cost-n	0
surgeon-n	professional-n	0
surprise-n	feeling-n	0
swan-n	bird-n	0
swap-n	transaction-n	0
sweater-n	commodity-n	0
sweetness-n	sensation-n	0
swimmer-n	athlete-n	0
swimming-n	sport-n	0
symphony-n	music-n	0
symphony-n	sonata-n	0
symposium-n	meeting-n	0
syringe-n	instrument-n	0
tank-n	vehicle-n	0
tanker-n	ship-n	0
tanker-n	vehicle-n	0
tar-n	chemical-n	0
taste-n	sensation-n	0
tavern-n	building-n	0
taxonomy-n	hierarchy-n	0
tea-n	beverage-n	0
teacher-n	professional-n	0
teaching-n	occupation-n	0
technician-n	worker-n	0
telegraph-n	apparatus-n	0
telephony-n	telecommunication-n	0
telescope-n	instrument-n	0
telly-n	receiver-n	0
temperament-n	trait-n	0
ten-n	integer-n	0
tenant-n	payer-n	0
tench-n	animal-n	0
tench-n	fish-n	0
term-n	word-n	0
terminal-n	facility-n	0
tern-n	vertebrate-n	0
terrier-n	carnivore-n	0
terrier-n	dog-n	0
terror-n	emotion-n	0
terror-n	feeling-n	0
textbook-n	book-n	0
theater-n	building-n	0
theatre-n	building-n	0
theft-n	felony-n	0
theology-n	discipline-n	0
therapy-n	care-n	0
thermostat-n	regulator-n	0
thesaurus-n	publication-n	0
thief-n	criminal-n	0
thirty-n	integer-n	0
thoroughfare-n	road-n	0
thrill-n	emotion-n	0
throne-n	chair-n	0
throne-n	furniture-n	0
thunderstorm-n	storm-n	0
ticket-n	document-n	0
tie-n	clothing-n	0
tip-n	end-n	0
title-n	text-n	0
toad-n	animal-n	0
toast-n	bread-n	0
toast-n	food-n	0
toddler-n	child-n	0
toe-n	extremity-n	0
tomorrow-n	day-n	0
tongue-n	organ-n	0
tortoise-n	animal-n	0
tortoise-n	reptile-n	0
tour-n	travel-n	0
traction-n	phenomenon-n	0
traitor-n	criminal-n	0
transplantation-n	procedure-n	0
trolley-n	vehicle-n	0
trouser-n	garment-n	0
trumpeter-n	entertainer-n	0
trumpeter-n	performer-n	0
tsunami-n	wave-n	0
tuberculosis-n	disease-n	0
tummy-n	tissue-n	0
tumor-n	illness-n	0
tumour-n	illness-n	0
turbine-n	engine-n	0
turkey-n	animal-n	0
turkey-n	bird-n	0
turnpike-n	gate-n	0
turquoise-n	crystal-n	0
turret-n	tower-n	0
tutor-n	teacher-n	0
twelve-n	integer-n	0
twenty-n	integer-n	0
tycoon-n	businessman-n	0
typhoon-n	phenomenon-n	0
typhoon-n	storm-n	0
typography-n	occupation-n	0
tyrant-n	ruler-n	0
ultimatum-n	request-n	0
underside-n	boundary-n	0
underwear-n	clothing-n	0
uprising-n	conflict-n	0
uterus-n	organ-n	0
value-n	idea-n	0
vandalism-n	mischief-n	0
vegan-n	eater-n	0
veil-n	garment-n	0
velocity-n	rate-n	0
velvet-n	fabric-n	0
vertebrate-n	animal-n	0
vertex-n	point-n	0
vi-n	digit-n	0
vial-n	container-n	0
vicar-n	clergyman-n	0
vicar-n	leader-n	0
vicar-n	priest-n	0
vicarage-n	building-n	0
vicarage-n	dwelling-n	0
vicinity-n	area-n	0
victimisation-n	practice-n	0
vintage-n	beverage-n	0
vintage-n	liquid-n	0
violinist-n	entertainer-n	0
virus-n	microorganism-n	0
visualisation-n	representation-n	0
vocalist-n	performer-n	0
vodka-n	alcohol-n	0
voice-n	sound-n	0
vole-n	animal-n	0
vole-n	rodent-n	0
vole-n	vertebrate-n	0
volleyball-n	game-n	0
volleyball-n	sport-n	0
vulture-n	vertebrate-n	0
wader-n	bird-n	0
wader-n	vertebrate-n	0
wage-n	payment-n	0
waiter-n	employee-n	0
waitress-n	employee-n	0
waitress-n	waiter-n	0
waitress-n	worker-n	0
walnut-n	nut-n	0
walnut-n	seed-n	0
warbler-n	entertainer-n	0
warbler-n	performer-n	0
warbler-n	singer-n	0
warrant-n	document-n	0
warship-n	vehicle-n	0
washer-n	worker-n	0
waterfowl-n	animal-n	0
weakening-n	transformation-n	0
weapon-n	instrument-n	0
webcam-n	camera-n	0
wheat-n	cereal-n	0
whiskey-n	drug-n	0
whiskey-n	fluid-n	0
whiskey-n	liquid-n	0
whiskey-n	liquor-n	0
whisky-n	beverage-n	0
whisky-n	fluid-n	0
wife-n	spouse-n	0
windfall-n	fruit-n	0
wine-n	alcohol-n	0
wine-n	fluid-n	0
winger-n	athlete-n	0
winner-n	contestant-n	0
wolf-n	carnivore-n	0
wolf-n	vertebrate-n	0
woman-n	adult-n	0
woodpecker-n	animal-n	0
woodpecker-n	bird-n	0
workbook-n	publication-n	0
worm-n	invertebrate-n	0
wrath-n	emotion-n	0
writer-n	communicator-n	0
yearning-n	feeling-n	0
yellow-n	color-n	0
yesterday-n	day-n	0
yoghurt-n	food-n	0
zeal-n	feeling-n	0
zebra-n	animal-n	0
adjective-n	document-n	0
adrenaline-n	integer-n	0
adult-n	anaesthetist-n	0
adult-n	gent-n	0
adult-n	instrument-n	0
adult-n	librarian-n	0
adult-n	nanny-n	0
adult-n	physician-n	0
adult-n	tree-n	0
advocate-n	spokeswoman-n	0
affection-n	organization-n	0
agony-n	adult-n	0
agony-n	anaesthetist-n	0
agony-n	decoration-n	0
agreement-n	rector-n	0
aircraft-n	astronomy-n	0
aircraft-n	biplane-n	0
aircraft-n	bomber-n	0
aircraft-n	insect-n	0
aircraft-n	letter-n	0
aircrew-n	playlist-n	0
airman-n	sociology-n	0
airplane-n	bomber-n	0
airplane-n	chalet-n	0
alcohol-n	container-n	0
alcohol-n	hotel-n	0
alcohol-n	liqueur-n	0
alcohol-n	psychology-n	0
alga-n	garment-n	0
algebra-n	athlete-n	0
algebra-n	potato-n	0
alloy-n	bronze-n	0
ancestor-n	motto-n	0
anger-n	lizard-n	0
animal-n	affidavit-n	0
animal-n	artillery-n	0
animal-n	bitterness-n	0
animal-n	bug-n	0
animal-n	bull-n	0
animal-n	calf-n	0
animal-n	cameraman-n	0
animal-n	chick-n	0
animal-n	color-n	0
animal-n	crow-n	0
animal-n	diabetes-n	0
animal-n	dorm-n	0
animal-n	feeder-n	0
animal-n	funeral-n	0
animal-n	furniture-n	0
animal-n	gasoline-n	0
animal-n	hawk-n	0
animal-n	immigration-n	0
animal-n	invertebrate-n	0
animal-n	kangaroo-n	0
animal-n	kestrel-n	0
animal-n	kickoff-n	0
animal-n	lamb-n	0
animal-n	lion-n	0
animal-n	maggot-n	0
animal-n	magpie-n	0
animal-n	organization-n	0
animal-n	panda-n	0
animal-n	psychotherapy-n	0
animal-n	python-n	0
animal-n	receptionist-n	0
animal-n	reindeer-n	0
animal-n	reptile-n	0
animal-n	robin-n	0
animal-n	ship-n	0
animal-n	snake-n	0
animal-n	toad-n	0
animal-n	turkey-n	0
animal-n	vertebrate-n	0
animal-n	vial-n	0
animal-n	waterfowl-n	0
anniversary-n	lingerie-n	0
anorexia-n	fixture-n	0
ant-n	spokeswoman-n	0
antibiotic-n	penicillin-n	0
antibody-n	nematode-n	0
apathy-n	magnitude-n	0
apathy-n	mammal-n	0
ape-n	book-n	0
apprehension-n	bird-n	0
apprehension-n	offspring-n	0
apprehension-n	skating-n	0
aqueduct-n	pianist-n	0
archbishop-n	garment-n	0
area-n	cameraman-n	0
aristocrat-n	baroness-n	0
aristocrat-n	relative-n	0
armament-n	cannon-n	0
armament-n	people-n	0
army-n	waterfowl-n	0
art-n	beard-n	0
art-n	cost-n	0
art-n	serpent-n	0
artillery-n	cannon-n	0
artist-n	beverage-n	0
artwork-n	integer-n	0
asp-n	invertebrate-n	0
asp-n	workplace-n	0
asthma-n	motel-n	0
asthma-n	tissue-n	0
athlete-n	cricketer-n	0
athlete-n	dancer-n	0
athlete-n	filly-n	0
athlete-n	spokeswoman-n	0
athlete-n	swimmer-n	0
attack-n	animal-n	0
attitude-n	bookshop-n	0
auto-n	trait-n	0
autobiography-n	feeling-n	0
badminton-n	kettle-n	0
bag-n	collagen-n	0
bag-n	review-n	0
bag-n	rucksack-n	0
bamboo-n	bear-n	0
ban-n	performer-n	0
baritone-n	adrenaline-n	0
barrier-n	fender-n	0
barrier-n	gate-n	0
barrier-n	psychotherapy-n	0
bead-n	decoration-n	0
bead-n	performer-n	0
bear-n	webcam-n	0
bed-n	insect-n	0
beech-n	artillery-n	0
beer-n	machine-n	0
beer-n	railway-n	0
benzene-n	cottage-n	0
benzene-n	tent-n	0
berry-n	diplomat-n	0
beverage-n	art-n	0
beverage-n	beer-n	0
beverage-n	list-n	0
beverage-n	panda-n	0
beverage-n	sherry-n	0
beverage-n	strut-n	0
beverage-n	symbol-n	0
beverage-n	tea-n	0
beverage-n	vehicle-n	0
beverage-n	whisky-n	0
bib-n	herb-n	0
bike-n	gate-n	0
bin-n	mail-n	0
binder-n	disease-n	0
binder-n	notary-n	0
binder-n	performer-n	0
bingo-n	fluid-n	0
biochemistry-n	enzymology-n	0
biplane-n	ale-n	0
bird-n	chick-n	0
bird-n	cookie-n	0
bird-n	disorder-n	0
bird-n	eagle-n	0
bird-n	entertainer-n	0
bird-n	freeway-n	0
bird-n	hawk-n	0
bird-n	penguin-n	0
bird-n	seabird-n	0
bird-n	snake-n	0
bird-n	turkey-n	0
bird-n	woman-n	0
bird-n	woodpecker-n	0
bishop-n	cardinal-n	0
bishop-n	valley-n	0
boar-n	spokesperson-n	0
boat-n	chair-n	0
boat-n	cost-n	0
boat-n	dinghy-n	0
boat-n	pontoon-n	0
boat-n	reformer-n	0
bonnet-n	hamster-n	0
bonnet-n	vehicle-n	0
book-n	fruit-n	0
bookmark-n	performer-n	0
border-n	feeling-n	0
bottle-n	throne-n	0
bourgeoisie-n	association-n	0
bourgeoisie-n	fabric-n	0
bowling-n	clothing-n	0
bread-n	toast-n	0
breeze-n	heroism-n	0
breeze-n	physiology-n	0
buggy-n	garment-n	0
building-n	castle-n	0
building-n	craftsman-n	0
building-n	envy-n	0
building-n	instrument-n	0
building-n	mosque-n	0
building-n	motel-n	0
building-n	observatory-n	0
building-n	potato-n	0
building-n	shrine-n	0
building-n	theater-n	0
building-n	transaction-n	0
bull-n	highway-n	0
bureau-n	leaf-n	0
business-n	disease-n	0
business-n	meal-n	0
businessman-n	tycoon-n	0
butterfly-n	vertebrate-n	0
cabbage-n	aspirin-n	0
cabbage-n	toast-n	0
calculation-n	temperature-n	0
calf-n	worker-n	0
camera-n	clinician-n	0
camera-n	magistrate-n	0
campsite-n	discipline-n	0
campsite-n	disease-n	0
cancer-n	drug-n	0
cancer-n	drummer-n	0
cancer-n	melanoma-n	0
cancer-n	mesothelioma-n	0
cannon-n	tree-n	0
captivity-n	internment-n	0
car-n	limousine-n	0
car-n	sedan-n	0
carbohydrate-n	cellulose-n	0
carbonate-n	worker-n	0
carcinoma-n	granny-n	0
care-n	radiotherapy-n	0
caring-n	bacterium-n	0
carnivore-n	dog-n	0
carnivore-n	ferret-n	0
carnivore-n	glider-n	0
cassette-n	therapy-n	0
cat-n	drone-n	0
cat-n	locomotive-n	0
catcher-n	psoriasis-n	0
caterpillar-n	aesthetic-n	0
cellist-n	puppy-n	0
cellist-n	vehicle-n	0
cellulose-n	mineral-n	0
ceremony-n	initiation-n	0
chair-n	armchair-n	0
chamber-n	animal-n	0
chamber-n	house-n	0
chamber-n	objectivity-n	0
champagne-n	batsman-n	0
champagne-n	etching-n	0
chancellor-n	basket-n	0
chant-n	boss-n	0
cheese-n	kettle-n	0
chemical-n	benzene-n	0
chemical-n	carbonate-n	0
chemical-n	food-n	0
chemical-n	rat-n	0
chemistry-n	liquid-n	0
chemotherapy-n	rum-n	0
chick-n	seed-n	0
chick-n	smuggler-n	0
child-n	sherry-n	0
church-n	fence-n	0
classroom-n	music-n	0
cleaning-n	animal-n	0
cleaning-n	shaving-n	0
clergyman-n	archbishop-n	0
clergyman-n	vicar-n	0
clinician-n	software-n	0
clothing-n	denim-n	0
clothing-n	karaoke-n	0
clothing-n	kilt-n	0
clothing-n	shirt-n	0
clothing-n	tie-n	0
clubhouse-n	poem-n	0
coaching-n	chart-n	0
cockroach-n	alcohol-n	0
cocktail-n	affection-n	0
collagen-n	shopkeeper-n	0
collection-n	parasite-n	0
color-n	green-n	0
color-n	record-n	0
combustion-n	blaze-n	0
commerce-n	importation-n	0
commodity-n	annals-n	0
commodity-n	car-n	0
commodity-n	dryer-n	0
commodity-n	geek-n	0
commodity-n	kilt-n	0
commodity-n	staple-n	0
commodity-n	stocking-n	0
commodity-n	sweater-n	0
communicator-n	cradle-n	0
communicator-n	storyteller-n	0
communicator-n	writer-n	0
compensation-n	publication-n	0
competitiveness-n	dentistry-n	0
competitiveness-n	screenwriter-n	0
competitiveness-n	tumor-n	0
computer-n	catastrophe-n	0
computer-n	laptop-n	0
computer-n	pc-n	0
computer-n	vertebrate-n	0
concept-n	gastropod-n	0
condominium-n	gymnasium-n	0
conduit-n	aqueduct-n	0
conduit-n	writer-n	0
conservatism-n	mesothelioma-n	0
consistency-n	fly-n	0
consistency-n	hardness-n	0
consumer-n	drinker-n	0
container-n	disease-n	0
container-n	garment-n	0
container-n	kettle-n	0
container-n	lamb-n	0
container-n	pc-n	0
container-n	pouch-n	0
container-n	room-n	0
container-n	spokeswoman-n	0
container-n	spoon-n	0
container-n	teacher-n	0
container-n	technician-n	0
container-n	terminal-n	0
container-n	tip-n	0
contest-n	final-n	0
contest-n	vertebrate-n	0
contestant-n	building-n	0
contestant-n	winner-n	0
contract-n	musician-n	0
contractor-n	declaration-n	0
cook-n	point-n	0
cosmology-n	relief-n	0
cost-n	overhead-n	0
cost-n	vegetable-n	0
counterattack-n	seafood-n	0
coupe-n	pc-n	0
covenant-n	vehicle-n	0
cow-n	chocolate-n	0
crab-n	illness-n	0
cradle-n	airplane-n	0
crew-n	aircrew-n	0
criminal-n	bird-n	0
criminal-n	documentary-n	0
criminal-n	drone-n	0
criminology-n	sherry-n	0
crusade-n	therapy-n	0
crystal-n	ice-n	0
crystal-n	leader-n	0
crystal-n	malaria-n	0
crystal-n	turquoise-n	0
curve-n	feeling-n	0
curve-n	publication-n	0
curve-n	spiral-n	0
dad-n	animal-n	0
dad-n	milk-n	0
dagger-n	dolphin-n	0
dancer-n	autobiography-n	0
dart-n	motorway-n	0
day-n	tomorrow-n	0
dealership-n	terrier-n	0
dean-n	signal-n	0
deer-n	aromatherapy-n	0
dentistry-n	piracy-n	0
depth-n	roadway-n	0
dermatitis-n	tumor-n	0
descendent-n	housing-n	0
diabetes-n	corridor-n	0
diabetes-n	furniture-n	0
digit-n	iv-n	0
digit-n	ix-n	0
dimension-n	castle-n	0
dioxide-n	military-n	0
dioxin-n	package-n	0
diplomat-n	ambassador-n	0
disability-n	hare-n	0
disability-n	math-n	0
discipline-n	acoustics-n	0
discipline-n	anatomy-n	0
discipline-n	ceremony-n	0
discipline-n	geology-n	0
discipline-n	geometry-n	0
discipline-n	housing-n	0
discipline-n	limb-n	0
discipline-n	logic-n	0
discipline-n	neuroscience-n	0
discipline-n	pharmacy-n	0
discipline-n	psychotherapy-n	0
disease-n	animal-n	0
disease-n	colt-n	0
disease-n	diabetes-n	0
disease-n	flu-n	0
disease-n	gall-n	0
disease-n	herpes-n	0
disease-n	housing-n	0
disease-n	lupus-n	0
disease-n	worm-n	0
dish-n	integer-n	0
disorder-n	hysteria-n	0
disorder-n	insomnia-n	0
disorder-n	laboratory-n	0
disorder-n	symbol-n	0
doctrine-n	aesthetic-n	0
doctrine-n	privateer-n	0
document-n	affidavit-n	0
document-n	covenant-n	0
document-n	deity-n	0
document-n	solid-n	0
dog-n	annals-n	0
dog-n	bulldog-n	0
dog-n	greyhound-n	0
dog-n	kingfisher-n	0
dog-n	word-n	0
dogma-n	ship-n	0
dove-n	people-n	0
dragonfly-n	oil-n	0
drift-n	economist-n	0
drug-n	anaesthetic-n	0
drug-n	benzodiazepine-n	0
drug-n	hall-n	0
drug-n	jurisprudence-n	0
drummer-n	tree-n	0
dryer-n	cottage-n	0
dryer-n	parent-n	0
dwelling-n	chateau-n	0
dwelling-n	convent-n	0
dwelling-n	conversion-n	0
dyke-n	vertebrate-n	0
eagle-n	tip-n	0
eater-n	vegan-n	0
ecstasy-n	sport-n	0
editor-n	movie-n	0
eel-n	kingfisher-n	0
electrician-n	granny-n	0
electronics-n	professional-n	0
emotion-n	anger-n	0
emotion-n	animosity-n	0
emotion-n	displeasure-n	0
emotion-n	fright-n	0
emotion-n	resentment-n	0
empress-n	chemical-n	0
enclosure-n	cage-n	0
encyclopedia-n	ale-n	0
end-n	inn-n	0
endurance-n	reindeer-n	0
energy-n	heat-n	0
entertainer-n	artiste-n	0
entertainer-n	biologist-n	0
entertainer-n	cellist-n	0
entertainer-n	comic-n	0
entertainer-n	leg-n	0
entertainer-n	penguin-n	0
entertainer-n	piper-n	0
entertainer-n	trumpeter-n	0
entertainer-n	warbler-n	0
environmentalist-n	entertainer-n	0
enzyme-n	animal-n	0
enzyme-n	chick-n	0
equipment-n	attorney-n	0
equipment-n	camera-n	0
equipment-n	parachute-n	0
equipment-n	princess-n	0
equipment-n	reel-n	0
equipment-n	roofing-n	0
equipment-n	sherry-n	0
era-n	perseverance-n	0
era-n	pine-n	0
etching-n	discipline-n	0
excuse-n	physician-n	0
explanation-n	biplane-n	0
explanation-n	excuse-n	0
explanation-n	spore-n	0
explosive-n	aircraft-n	0
explosive-n	dynamite-n	0
fabric-n	sunshine-n	0
fabric-n	velvet-n	0
facade-n	outpost-n	0
facility-n	chalet-n	0
falcon-n	calculation-n	0
fallacy-n	produce-n	0
falsehood-n	flea-n	0
farmhouse-n	bargain-n	0
fear-n	ecologist-n	0
fear-n	suitcase-n	0
feeling-n	animosity-n	0
feeling-n	artillery-n	0
feeling-n	benzodiazepine-n	0
feeling-n	compassion-n	0
feeling-n	desire-n	0
feeling-n	doctrine-n	0
feeling-n	envy-n	0
feeling-n	insect-n	0
feeling-n	jealousy-n	0
feeling-n	longing-n	0
feeling-n	love-n	0
feeling-n	military-n	0
feeling-n	nostalgia-n	0
feeling-n	passion-n	0
feeling-n	relief-n	0
feeling-n	resignation-n	0
feeling-n	rum-n	0
feeling-n	serviceman-n	0
feeling-n	surprise-n	0
feeling-n	terror-n	0
feeling-n	weapon-n	0
felony-n	panda-n	0
fiber-n	entertainer-n	0
fillet-n	antibiotic-n	0
fillet-n	glider-n	0
final-n	cotton-n	0
firm-n	carnivore-n	0
firm-n	publisher-n	0
fish-n	kestrel-n	0
fish-n	shark-n	0
fluid-n	alcohol-n	0
fluid-n	beverage-n	0
fluid-n	cider-n	0
fluid-n	record-n	0
fluid-n	rum-n	0
fluid-n	whiskey-n	0
fluorescence-n	sausage-n	0
fly-n	grandchild-n	0
folly-n	dealer-n	0
folly-n	tent-n	0
food-n	candy-n	0
food-n	gun-n	0
food-n	honey-n	0
food-n	margarine-n	0
food-n	pizza-n	0
food-n	reimbursement-n	0
food-n	sandwich-n	0
food-n	spaghetti-n	0
food-n	woman-n	0
football-n	fixture-n	0
football-n	hamlet-n	0
forearm-n	merchant-n	0
foundry-n	typhoon-n	0
fragrance-n	leader-n	0
freeway-n	district-n	0
fruit-n	illness-n	0
fruit-n	melon-n	0
fruit-n	olive-n	0
fruit-n	pear-n	0
fruit-n	pizza-n	0
frustration-n	terror-n	0
fuel-n	tumor-n	0
fullback-n	baronetcy-n	0
funeral-n	carnivore-n	0
furniture-n	desk-n	0
furniture-n	shark-n	0
furniture-n	soprano-n	0
furniture-n	throne-n	0
furniture-n	word-n	0
game-n	bowling-n	0
game-n	netball-n	0
game-n	reelection-n	0
game-n	snooker-n	0
garment-n	eater-n	0
garment-n	jean-n	0
garment-n	lingerie-n	0
gasoline-n	hymn-n	0
gastropod-n	music-n	0
gate-n	violinist-n	0
gathering-n	seminar-n	0
gemstone-n	mammal-n	0
gent-n	entertainer-n	0
gent-n	playing-n	0
geology-n	charcoal-n	0
geometry-n	emotion-n	0
goalkeeper-n	documentary-n	0
golfer-n	tower-n	0
goose-n	victim-n	0
governor-n	drift-n	0
grandchild-n	drug-n	0
grandparent-n	grandfather-n	0
graveyard-n	transaction-n	0
greyhound-n	collection-n	0
greyhound-n	eatery-n	0
greyhound-n	symbol-n	0
greyhound-n	symphony-n	0
gun-n	crusade-n	0
gym-n	panda-n	0
hair-n	beard-n	0
hair-n	desire-n	0
hamlet-n	condominium-n	0
hamster-n	science-n	0
handgun-n	chick-n	0
handgun-n	worker-n	0
handset-n	phenomenon-n	0
hare-n	fillet-n	0
heat-n	armchair-n	0
heat-n	ticket-n	0
height-n	quarterback-n	0
helicopter-n	courthouse-n	0
herb-n	osteoarthritis-n	0
herb-n	rue-n	0
herb-n	vehicle-n	0
heroism-n	melanoma-n	0
herring-n	feeling-n	0
heterogeneity-n	discipline-n	0
heterogeneity-n	vertebrate-n	0
highway-n	machine-n	0
holly-n	official-n	0
horse-n	bear-n	0
horse-n	science-n	0
horse-n	stallion-n	0
host-n	hostess-n	0
hostel-n	lingerie-n	0
hound-n	greyhound-n	0
hound-n	python-n	0
house-n	castle-n	0
house-n	chalet-n	0
house-n	monastery-n	0
house-n	priory-n	0
house-n	serviceman-n	0
housewife-n	hawk-n	0
housing-n	criminal-n	0
housing-n	guesthouse-n	0
housing-n	manor-n	0
housing-n	monastery-n	0
housing-n	percussionist-n	0
housing-n	supper-n	0
husband-n	competitiveness-n	0
hydrocarbon-n	gasoline-n	0
hydrocarbon-n	statement-n	0
icon-n	disease-n	0
idea-n	fender-n	0
idea-n	value-n	0
illness-n	asylum-n	0
illness-n	digit-n	0
illness-n	document-n	0
illness-n	mesothelioma-n	0
illness-n	smallpox-n	0
illness-n	tumor-n	0
illness-n	tumour-n	0
illustration-n	milk-n	0
immunology-n	investment-n	0
infant-n	investor-n	0
inference-n	vehicle-n	0
inference-n	yearning-n	0
influenza-n	staple-n	0
information-n	corporation-n	0
information-n	disease-n	0
information-n	documentation-n	0
information-n	pine-n	0
information-n	playlist-n	0
information-n	propaganda-n	0
information-n	surgeon-n	0
information-n	waitress-n	0
infusion-n	animal-n	0
inhabitant-n	islander-n	0
inhabitant-n	resident-n	0
insect-n	ant-n	0
insect-n	cricket-n	0
insect-n	drone-n	0
insect-n	fencing-n	0
insect-n	illness-n	0
insect-n	librarian-n	0
insomnia-n	dictionary-n	0
institution-n	produce-n	0
institution-n	seminary-n	0
instrument-n	animal-n	0
instrument-n	gauge-n	0
instrument-n	missile-n	0
instrument-n	motorcycle-n	0
instrument-n	radar-n	0
instrument-n	royalty-n	0
instrument-n	telescope-n	0
instrument-n	voice-n	0
instrument-n	zebra-n	0
integer-n	animal-n	0
integer-n	ecstasy-n	0
integer-n	eleven-n	0
integer-n	fish-n	0
integer-n	rodent-n	0
integer-n	ten-n	0
integer-n	twenty-n	0
interoperability-n	height-n	0
intestine-n	equipment-n	0
intranet-n	negation-n	0
invertebrate-n	ant-n	0
invertebrate-n	gastropod-n	0
invertebrate-n	science-n	0
invertebrate-n	soprano-n	0
jam-n	trait-n	0
jelly-n	chapel-n	0
jewel-n	gunboat-n	0
jewel-n	invitation-n	0
jewelry-n	computer-n	0
jewelry-n	drummer-n	0
jewelry-n	freeware-n	0
jigsaw-n	alga-n	0
jigsaw-n	handgun-n	0
jigsaw-n	worker-n	0
joint-n	change-n	0
joint-n	knuckle-n	0
journalist-n	columnist-n	0
kangaroo-n	castle-n	0
karaoke-n	merchant-n	0
kestrel-n	liquor-n	0
kestrel-n	netball-n	0
kestrel-n	worker-n	0
keyboardist-n	cricket-n	0
kilt-n	monoclonal-n	0
kindergarten-n	symbol-n	0
knife-n	raven-n	0
laborer-n	solid-n	0
lactose-n	pony-n	0
lactose-n	writer-n	0
laptop-n	ice-n	0
larva-n	caterpillar-n	0
larva-n	maggot-n	0
leader-n	boss-n	0
leader-n	pope-n	0
leader-n	rider-n	0
leader-n	science-n	0
leader-n	statesman-n	0
leader-n	vehicle-n	0
leaf-n	petal-n	0
lecturer-n	rate-n	0
leg-n	microorganism-n	0
lemon-n	humanist-n	0
lemon-n	throne-n	0
leprosy-n	kestrel-n	0
lesbian-n	crowd-n	0
lesbian-n	dyke-n	0
librarian-n	document-n	0
light-n	resident-n	0
limb-n	leg-n	0
limousine-n	workbook-n	0
lingerie-n	payer-n	0
lingerie-n	remorse-n	0
liqueur-n	feeling-n	0
liqueur-n	ten-n	0
liquid-n	beer-n	0
liquid-n	beverage-n	0
liquid-n	jewelry-n	0
liquid-n	liquor-n	0
liquid-n	pet-n	0
liquid-n	progenitor-n	0
liquid-n	road-n	0
liquid-n	sherry-n	0
liquid-n	standing-n	0
liquid-n	vintage-n	0
liquor-n	odyssey-n	0
list-n	chapel-n	0
list-n	enumeration-n	0
lizard-n	entertainer-n	0
logic-n	crime-n	0
logic-n	mammal-n	0
logo-n	squid-n	0
machine-n	biochemistry-n	0
machine-n	pc-n	0
maggot-n	muse-n	0
magnitude-n	beverage-n	0
magnitude-n	radius-n	0
magnitude-n	size-n	0
magpie-n	science-n	0
maid-n	bench-n	0
mail-n	postcard-n	0
mailbox-n	crusade-n	0
mammal-n	biochemistry-n	0
mammal-n	bitterness-n	0
mammal-n	boar-n	0
mammal-n	cat-n	0
mammal-n	chimpanzee-n	0
mammal-n	disease-n	0
mammal-n	enzyme-n	0
mammal-n	fox-n	0
mammal-n	goat-n	0
mammal-n	horse-n	0
mammal-n	illness-n	0
mammal-n	intranet-n	0
mammal-n	machine-n	0
mammal-n	mankind-n	0
mammal-n	rat-n	0
mammal-n	vegetable-n	0
man-n	pronoun-n	0
manor-n	archbishop-n	0
manual-n	servant-n	0
mariner-n	ruler-n	0
marker-n	bookmark-n	0
massage-n	petroleum-n	0
mater-n	range-n	0
mater-n	turret-n	0
meal-n	dinner-n	0
meal-n	reptile-n	0
meal-n	sport-n	0
meal-n	supper-n	0
meat-n	clown-n	0
meat-n	vertebrate-n	0
medium-n	animal-n	0
medium-n	invertebrate-n	0
meeting-n	convention-n	0
meeting-n	leader-n	0
meeting-n	orchid-n	0
melanoma-n	note-n	0
member-n	regent-n	0
memo-n	vehicle-n	0
memorandum-n	racing-n	0
merchant-n	shopkeeper-n	0
mesothelioma-n	ambassador-n	0
mesothelioma-n	maker-n	0
message-n	asylum-n	0
message-n	occupation-n	0
midwife-n	alcohol-n	0
migraine-n	staple-n	0
migrant-n	feeling-n	0
migration-n	organization-n	0
militia-n	leader-n	0
mime-n	fairytale-n	0
miner-n	arthritis-n	0
miner-n	officer-n	0
mischief-n	collagen-n	0
mischief-n	hydrocarbon-n	0
mischief-n	vandalism-n	0
misfortune-n	calamity-n	0
misfortune-n	catastrophe-n	0
misfortune-n	mom-n	0
mishap-n	symposium-n	0
missile-n	vole-n	0
molecule-n	cancer-n	0
molecule-n	carbohydrate-n	0
molecule-n	lipid-n	0
molecule-n	locomotive-n	0
molecule-n	monoclonal-n	0
molecule-n	toast-n	0
molecule-n	vehicle-n	0
mollusc-n	business-n	0
moratorium-n	valley-n	0
mortar-n	insecticide-n	0
mosque-n	castle-n	0
mother-n	food-n	0
motorcycle-n	karaoke-n	0
motorist-n	firearm-n	0
motto-n	logo-n	0
movie-n	documentary-n	0
murderer-n	competitiveness-n	0
murderer-n	eleven-n	0
music-n	concerto-n	0
music-n	monarch-n	0
music-n	reggae-n	0
musician-n	piper-n	0
musician-n	road-n	0
musician-n	soloist-n	0
musket-n	player-n	0
musket-n	rate-n	0
name-n	gent-n	0
narrative-n	fairytale-n	0
narrative-n	wine-n	0
netball-n	sport-n	0
netball-n	vehicle-n	0
nickname-n	disability-n	0
nipple-n	heterogeneity-n	0
nostalgia-n	integer-n	0
nostalgia-n	offspring-n	0
note-n	cockroach-n	0
note-n	memorandum-n	0
note-n	vehicle-n	0
nurse-n	amphibian-n	0
objectivity-n	visualisation-n	0
obstruction-n	performer-n	0
occupation-n	cleaning-n	0
occupation-n	pharmacy-n	0
occupation-n	professorship-n	0
occupation-n	vertebrate-n	0
officer-n	daughter-n	0
official-n	cardinal-n	0
official-n	grandmother-n	0
official-n	science-n	0
offspring-n	arithmetic-n	0
offspring-n	granddaughter-n	0
offspring-n	son-n	0
ointment-n	smallpox-n	0
oncology-n	skating-n	0
opening-n	feeling-n	0
opening-n	leak-n	0
ore-n	clown-n	0
organ-n	animal-n	0
organ-n	barrier-n	0
organ-n	intestine-n	0
organ-n	nipple-n	0
organ-n	penis-n	0
organ-n	uterus-n	0
organist-n	enzymology-n	0
organization-n	bear-n	0
organization-n	bureau-n	0
organization-n	church-n	0
organization-n	club-n	0
organization-n	department-n	0
organization-n	directorate-n	0
organization-n	galley-n	0
organization-n	math-n	0
organization-n	militia-n	0
osteoarthritis-n	catcher-n	0
overpayment-n	therapist-n	0
oxide-n	list-n	0
oyster-n	science-n	0
palace-n	electrician-n	0
pancreas-n	coach-n	0
panda-n	woodpecker-n	0
parapet-n	insect-n	0
parasite-n	adjective-n	0
parasite-n	emotion-n	0
parasite-n	flea-n	0
parent-n	daddy-n	0
parrot-n	food-n	0
passageway-n	corridor-n	0
patience-n	ceremony-n	0
payment-n	hostess-n	0
payment-n	overpayment-n	0
payment-n	royalty-n	0
payment-n	solid-n	0
payment-n	wage-n	0
pc-n	food-n	0
pear-n	weapon-n	0
penis-n	color-n	0
penis-n	larva-n	0
people-n	bourgeoisie-n	0
people-n	gentry-n	0
people-n	vicar-n	0
performer-n	artiste-n	0
performer-n	comedian-n	0
performer-n	comic-n	0
performer-n	commodity-n	0
performer-n	disease-n	0
performer-n	drummer-n	0
performer-n	food-n	0
performer-n	geek-n	0
performer-n	mime-n	0
performer-n	physiotherapy-n	0
performer-n	saxophonist-n	0
performer-n	soprano-n	0
performer-n	spear-n	0
performer-n	vocalist-n	0
pesticide-n	beard-n	0
pesticide-n	cabbage-n	0
pesticide-n	girlfriend-n	0
pesticide-n	insecticide-n	0
petal-n	neurology-n	0
petal-n	vehicle-n	0
petroleum-n	payment-n	0
pew-n	glider-n	0
pharmacology-n	man-n	0
phenomenon-n	compensation-n	0
phenomenon-n	fluorescence-n	0
phenomenon-n	gale-n	0
phenomenon-n	mishap-n	0
phenomenon-n	polarization-n	0
phenomenon-n	rain-n	0
phenomenon-n	traction-n	0
physician-n	shelter-n	0
physiology-n	calculation-n	0
pig-n	science-n	0
pilgrimage-n	crew-n	0
piper-n	illness-n	0
piracy-n	feeling-n	0
pirate-n	adult-n	0
pistol-n	athlete-n	0
plant-n	rector-n	0
platter-n	publication-n	0
player-n	batsman-n	0
player-n	goalkeeper-n	0
player-n	instrument-n	0
player-n	physiotherapy-n	0
player-n	quarterback-n	0
playlist-n	bat-n	0
pocket-n	vehicle-n	0
polarization-n	emotion-n	0
policeman-n	theft-n	0
polygon-n	rectangle-n	0
polymer-n	oil-n	0
polymerase-n	treatment-n	0
porter-n	panic-n	0
post-n	rabbit-n	0
postgraduate-n	water-n	0
potato-n	foreman-n	0
pram-n	greyhound-n	0
preamble-n	meal-n	0
preconception-n	laboratory-n	0
prefecture-n	musician-n	0
priest-n	pocket-n	0
priest-n	secretariat-n	0
priory-n	tycoon-n	0
procedure-n	melon-n	0
produce-n	music-n	0
produce-n	raisin-n	0
professional-n	anaesthetist-n	0
professional-n	craftsman-n	0
professional-n	liquor-n	0
professional-n	ruler-n	0
professional-n	surgeon-n	0
professional-n	teacher-n	0
professorship-n	misfortune-n	0
progenitor-n	dad-n	0
progenitor-n	father-n	0
progenitor-n	mother-n	0
projectile-n	limb-n	0
prosecutor-n	magnitude-n	0
protein-n	collagen-n	0
protein-n	kilt-n	0
pseudonym-n	dwelling-n	0
pseudonym-n	golf-n	0
psychiatry-n	clinician-n	0
psychoanalysis-n	cow-n	0
psychotherapy-n	dinner-n	0
publication-n	bestseller-n	0
publication-n	linguist-n	0
publication-n	manual-n	0
publication-n	workbook-n	0
pudding-n	wind-n	0
puppy-n	employee-n	0
puppy-n	performer-n	0
race-n	dioxin-n	0
radius-n	fluid-n	0
railway-n	metro-n	0
rain-n	drizzle-n	0
receptionist-n	schoolmaster-n	0
record-n	autobiography-n	0
record-n	memo-n	0
record-n	spouse-n	0
record-n	wine-n	0
red-n	bird-n	0
reelection-n	ache-n	0
reformer-n	crime-n	0
reggae-n	rectangle-n	0
reimbursement-n	insect-n	0
relative-n	game-n	0
relative-n	granny-n	0
relative-n	infant-n	0
relative-n	leader-n	0
relative-n	musician-n	0
relative-n	ore-n	0
relative-n	parent-n	0
relative-n	son-n	0
relief-n	herb-n	0
relief-n	kidnapping-n	0
remorse-n	water-n	0
representative-n	alderman-n	0
reptile-n	business-n	0
reptile-n	list-n	0
reptile-n	record-n	0
request-n	ultimatum-n	0
resentment-n	employee-n	0
resignation-n	discipline-n	0
revolver-n	animal-n	0
rifle-n	psychoanalysis-n	0
right-n	kingfisher-n	0
road-n	freeway-n	0
road-n	highway-n	0
road-n	representative-n	0
road-n	roadway-n	0
roast-n	salmon-n	0
rodent-n	hamster-n	0
rodent-n	hedgehog-n	0
rodent-n	vole-n	0
rodent-n	weapon-n	0
roofing-n	recovery-n	0
room-n	classroom-n	0
room-n	sauna-n	0
ruler-n	algebra-n	0
ruler-n	pancreas-n	0
sack-n	apostle-n	0
sack-n	emotion-n	0
sailor-n	forearm-n	0
sailor-n	oil-n	0
sailor-n	privateer-n	0
salesman-n	ache-n	0
salmon-n	intestine-n	0
sausage-n	crew-n	0
saying-n	machine-n	0
saying-n	motto-n	0
saying-n	slogan-n	0
scapegoat-n	temperament-n	0
school-n	gymnasium-n	0
science-n	alga-n	0
science-n	algebra-n	0
science-n	artery-n	0
science-n	concept-n	0
science-n	decree-n	0
science-n	dentistry-n	0
science-n	employee-n	0
science-n	linguistics-n	0
science-n	math-n	0
science-n	neurology-n	0
science-n	neuroscience-n	0
science-n	oncology-n	0
science-n	pear-n	0
science-n	robin-n	0
science-n	wheat-n	0
scientist-n	dad-n	0
scientist-n	henchman-n	0
scourge-n	end-n	0
seabird-n	penguin-n	0
seafood-n	carp-n	0
seafood-n	herring-n	0
seafood-n	mackerel-n	0
seafood-n	worker-n	0
seaplane-n	crystal-n	0
secretariat-n	carbon-n	0
section-n	preamble-n	0
security-n	fresco-n	0
security-n	indemnity-n	0
sedan-n	tissue-n	0
sensation-n	fragrance-n	0
sensation-n	information-n	0
sensation-n	molecule-n	0
sensation-n	tool-n	0
servant-n	croquet-n	0
serviceman-n	soldier-n	0
shark-n	assortment-n	0
shellfish-n	emotion-n	0
sherry-n	cancer-n	0
sherry-n	rodent-n	0
ship-n	submarine-n	0
ship-n	tanker-n	0
shirt-n	thoroughfare-n	0
shortcut-n	decoration-n	0
shortcut-n	feeling-n	0
shower-n	bee-n	0
shrine-n	captivity-n	0
signal-n	walnut-n	0
singer-n	soprano-n	0
sir-n	opium-n	0
site-n	reptile-n	0
sixty-n	relative-n	0
slalom-n	barrier-n	0
slalom-n	hedgehog-n	0
slogan-n	mixture-n	0
sloop-n	rector-n	0
snail-n	bull-n	0
snake-n	chemical-n	0
snake-n	jewel-n	0
snippet-n	feeling-n	0
soccer-n	organization-n	0
sociologist-n	panda-n	0
software-n	food-n	0
software-n	fruit-n	0
software-n	parser-n	0
solid-n	ancestor-n	0
solid-n	ape-n	0
solid-n	cookie-n	0
solid-n	orange-n	0
solid-n	quartz-n	0
solid-n	shellfish-n	0
solid-n	wood-n	0
solution-n	batsman-n	0
solution-n	migration-n	0
son-n	hospital-n	0
sonata-n	symphony-n	0
song-n	piper-n	0
spaghetti-n	commodity-n	0
spaghetti-n	forearm-n	0
spaghetti-n	workman-n	0
spoon-n	immigration-n	0
sport-n	badminton-n	0
sport-n	equipment-n	0
sport-n	football-n	0
sport-n	garment-n	0
sport-n	golf-n	0
sport-n	histogram-n	0
sport-n	hymn-n	0
sport-n	racing-n	0
sport-n	swimming-n	0
spouse-n	commodity-n	0
stag-n	eagle-n	0
stag-n	virus-n	0
stallion-n	statement-n	0
standing-n	animal-n	0
standing-n	ape-n	0
statement-n	accusation-n	0
statement-n	contract-n	0
statement-n	ship-n	0
statement-n	spouse-n	0
statesman-n	buggy-n	0
status-n	baronetcy-n	0
stocking-n	bird-n	0
stocking-n	limousine-n	0
storm-n	overpayment-n	0
storm-n	sandwich-n	0
storm-n	solid-n	0
storm-n	typhoon-n	0
strawberry-n	alcohol-n	0
subcommittee-n	fresco-n	0
subcontractor-n	cassette-n	0
sulphate-n	hair-n	0
sunlight-n	dealer-n	0
sunlight-n	statement-n	0
surface-n	screen-n	0
surprise-n	guesthouse-n	0
swan-n	symbol-n	0
swimming-n	motel-n	0
swine-n	humankind-n	0
symbol-n	cairn-n	0
symbol-n	leaf-n	0
symbol-n	vehicle-n	0
symptom-n	spasm-n	0
system-n	military-n	0
tank-n	building-n	0
tanker-n	grandmother-n	0
technician-n	relative-n	0
telecommunication-n	crime-n	0
telecommunication-n	twenty-n	0
temperament-n	aristocrat-n	0
term-n	telly-n	0
tern-n	discipline-n	0
terror-n	granny-n	0
text-n	illustration-n	0
text-n	invitation-n	0
theater-n	value-n	0
theatre-n	brook-n	0
theology-n	greyhound-n	0
theology-n	phenomenon-n	0
therapy-n	building-n	0
therapy-n	machine-n	0
therapy-n	psychoanalysis-n	0
therapy-n	son-n	0
thief-n	housing-n	0
thief-n	potato-n	0
thoroughfare-n	alley-n	0
thoroughfare-n	boulevard-n	0
thrill-n	energy-n	0
thunderstorm-n	shower-n	0
tissue-n	animal-n	0
tissue-n	skin-n	0
tissue-n	solution-n	0
toast-n	antibiotic-n	0
toddler-n	lobster-n	0
tomorrow-n	relative-n	0
tool-n	celery-n	0
tool-n	fluid-n	0
tool-n	screwdriver-n	0
tortoise-n	joint-n	0
tower-n	aneurysm-n	0
tower-n	silo-n	0
tower-n	turret-n	0
traction-n	influenza-n	0
trait-n	competitiveness-n	0
trait-n	folly-n	0
trait-n	goose-n	0
trait-n	maker-n	0
trait-n	parameter-n	0
trait-n	road-n	0
trait-n	temperament-n	0
transaction-n	investing-n	0
transformation-n	conversion-n	0
travel-n	algebra-n	0
travel-n	safari-n	0
traveler-n	owl-n	0
traveler-n	performer-n	0
treatment-n	alcohol-n	0
treatment-n	people-n	0
treatment-n	psychoanalysis-n	0
treatment-n	radiotherapy-n	0
tree-n	almond-n	0
tree-n	holly-n	0
tree-n	mango-n	0
tree-n	mangrove-n	0
tree-n	travel-n	0
trolley-n	soloist-n	0
trouser-n	geometry-n	0
tumor-n	laborer-n	0
tumor-n	melanoma-n	0
tumor-n	mesothelioma-n	0
tumor-n	pasta-n	0
tumor-n	writer-n	0
tumour-n	luncheon-n	0
turbine-n	cold-n	0
turkey-n	employee-n	0
typography-n	surface-n	0
underside-n	sensation-n	0
undertaking-n	robin-n	0
undertaking-n	slalom-n	0
underwear-n	lingerie-n	0
utensil-n	kettle-n	0
value-n	teaching-n	0
vegetable-n	artiste-n	0
vegetable-n	cabbage-n	0
vegetable-n	vehicle-n	0
vehicle-n	amphibian-n	0
vehicle-n	auto-n	0
vehicle-n	bike-n	0
vehicle-n	duck-n	0
vehicle-n	elm-n	0
vehicle-n	entertainer-n	0
vehicle-n	frigate-n	0
vehicle-n	gunboat-n	0
vehicle-n	invertebrate-n	0
vehicle-n	milk-n	0
vehicle-n	osteoarthritis-n	0
vehicle-n	parser-n	0
vehicle-n	sedan-n	0
vehicle-n	sloop-n	0
vehicle-n	tank-n	0
vehicle-n	trolley-n	0
vehicle-n	tsunami-n	0
vehicle-n	vintage-n	0
vehicle-n	warship-n	0
vehicle-n	woman-n	0
vehicle-n	worker-n	0
velocity-n	potato-n	0
velocity-n	sociology-n	0
vertebrate-n	art-n	0
vertebrate-n	asp-n	0
vertebrate-n	bat-n	0
vertebrate-n	bear-n	0
vertebrate-n	bitterness-n	0
vertebrate-n	chariot-n	0
vertebrate-n	conservatism-n	0
vertebrate-n	corporation-n	0
vertebrate-n	cow-n	0
vertebrate-n	crystal-n	0
vertebrate-n	eagle-n	0
vertebrate-n	hedgehog-n	0
vertebrate-n	lion-n	0
vertebrate-n	mare-n	0
vertebrate-n	organization-n	0
vertebrate-n	panda-n	0
vertebrate-n	pheasant-n	0
vertebrate-n	puppy-n	0
vertebrate-n	raven-n	0
vertebrate-n	serpent-n	0
vertebrate-n	site-n	0
vertebrate-n	spear-n	0
vertebrate-n	victim-n	0
vertebrate-n	vole-n	0
vertebrate-n	woodpecker-n	0
vertebrate-n	worker-n	0
vertebrate-n	yellow-n	0
vertex-n	priest-n	0
vessel-n	stick-n	0
vial-n	commodity-n	0
vicar-n	bottle-n	0
vicar-n	shareholder-n	0
vicar-n	suit-n	0
vodka-n	privateer-n	0
volleyball-n	pc-n	0
vulture-n	fluid-n	0
wader-n	science-n	0
wage-n	airplane-n	0
waiter-n	waitress-n	0
walk-n	vehicle-n	0
warbler-n	father-n	0
ware-n	feeling-n	0
ware-n	fork-n	0
ware-n	shirt-n	0
water-n	seawater-n	0
waterfowl-n	crystal-n	0
waterfowl-n	parent-n	0
wave-n	tsunami-n	0
weakening-n	invertebrate-n	0
weapon-n	rifle-n	0
wheat-n	pain-n	0
whiskey-n	dagger-n	0
whiskey-n	meal-n	0
whisky-n	traveler-n	0
wife-n	beer-n	0
wife-n	coupe-n	0
wind-n	vicar-n	0
windfall-n	bird-n	0
wine-n	football-n	0
wine-n	road-n	0
woman-n	bridesmaid-n	0
woman-n	math-n	0
woman-n	mistress-n	0
wood-n	maple-n	0
woodpecker-n	covenant-n	0
word-n	emotion-n	0
word-n	flu-n	0
word-n	modifier-n	0
word-n	trait-n	0
work-n	bird-n	0
worker-n	airman-n	0
worker-n	athlete-n	0
worker-n	breaker-n	0
worker-n	cook-n	0
worker-n	editor-n	0
worker-n	furniture-n	0
worker-n	hospital-n	0
worker-n	phenomenon-n	0
worker-n	pilot-n	0
worker-n	postman-n	0
worker-n	traveler-n	0
workman-n	fruit-n	0
workman-n	porter-n	0
workplace-n	snippet-n	0
workplace-n	studio-n	0
wrath-n	science-n	0
writer-n	armchair-n	0
writer-n	dramatist-n	0
writer-n	poet-n	0
yellow-n	protein-n	0
yesterday-n	discipline-n	0
yesterday-n	subcommittee-n	0
